"ref=""5051739"" r"
"ref=""520435216"""
"ref=""603481607"""
"ref=""603481611"""
"ref=""603481610"""
"ref=""603481733"""
"ref=""603481606"""
"ref=""603481602"""
"ref=""603481601"""
"ref=""603481603"""
"ref=""603481604"""
"ref=""603481056"""
"ref=""603481599"""
"ref=""603481597"""
"ref=""603481598"""
"ref=""603480978"""
"ref=""116268204"""
"ref=""603481592"""
"ref=""603481593"""
"ref=""603481590"""
"ref=""603481588"""
"ref=""603481591"""
"ref=""603481728"""
"ref=""603481587"""
"ref=""83031655"""
"ref=""176730963"""
"ref=""228412036"""
"ref=""228412044"""
"ref=""228412733"""
"ref=""228418314"""
"ref=""176779502"""
"ref=""228413438"""
"ref=""228413179"""
"ref=""176779454"""
"ref=""586764562"""
"ref=""586764346"""
"ref=""586764688"""
"ref=""586763464"""
"ref=""586764202"""
"ref=""586764559"""
"ref=""586764547"""
"ref=""503144068"""
"ref=""503144099"""
"ref=""503144102"""
"ref=""503144135"""
"ref=""503144133"""
"ref=""503144069"""
"ref=""267939998"
"ref=""99042439"""